Révision cours d'avant :
	I've you meet ... -> Yes I have
	Mind if I = est-ce que ca vous dérange

Mainframe = serveur
Process = traiter
store = stocker
support = supporter
Pc = personal computer = ordinateur personnel
Large-scale computing = Calcule a grande échelle
purposes = objectif
companies = entreprise

desktop = le bureau
monitor = écran
keybord = clavier
designed = concut
vertical case = le boitier d'ordinateur

don't prononce de u of built
enought = suffit

laptop = ordinateur portable
lightweight = léger
sharp images = images nette
touchpad = pavé tactile
sensitive = sensible
pointer = souris/curseur
slots = emplacements
electrical outlets available = prise électrique disponible

special digital pen = un stylo digitale/numérique spécial
fold = plier
editable text = texte éditable/modifiable
voice recognition = reconnaissance vocal
versatile = versatile/polyvalent

PDA = assistant personnel numérique
Hand-held = qu'on peut tenir a la main
palmtops = de poche
input = entrée
stylus = stylé
touchscreen = écran tactile
handwriting = écriture
enables = activer/permettre
characters = les lettres
software = logiciel

wireless = sans file
worn on = fonctionner

Phrasal verbs = verb+particle

clock in = pointer pour arriver
clock out = pointer pour partir
connect up = se connecter
dial up = composer un numéro
exit out = quitter

filter out =  filter ce qu'on voit
freeze up = se figer
go offline = se déconnecter
go online = se connecter
hack into = someone tried to hack account

hang up = déccrocher 
hold on = 
hook into = 
hook up =

key in = saisir
link up = relier
log in = ouvrir session
log out = fermer session
log up = se connecter a une session
