pretty + ajd = plutôt
medical appointment = rendez-vous médical

router = router
device = un appareil
networks = réseau
online diary = agenda en lingne
area = zone
browser = navigateur
is displayed = est affiché

don't prononce the w of who

software = logiciel
storage = stockage
classified into = classifier/ranger dans
include = inclure
comprise = comprend/constituer
competing = concurentiel
basic = basique
digital cameras = caméra numérique

RAM = random acess memory
ROM = read only memory

2 halves = 2 moitiés

such as = tel que

match = relier/ associer
halves = moitiés 
ripper = graveur
newbie = néophite
to provide = fournir
to extract files = pour extraire des fichiers

lets = laisser/permetre
enthusiastic = enthousiaste
Recycle Bin = poubelle de recyclage / corbeille
files = fichiers
stored = stocké
to delete = pour supprimer
through = a travers
satellite dish = antenne parabolique 

chip = puce électronic

a few more = quelques uns

compréhension oral